00000000000000000000
01111111111111111110
02222211111111111110
01111211111111111110
01111211111111111110
01111211111111111110
01111211111111111110
01111211111111111110
01122211111111111110
01111211111111111110
01111222222211111110
01111211111111111110
01111211111111111110
01111211111111111110
01111211111111111110
01111211111111111110
01111211111111111330
01111211111111133330
02222222222222333330
03333333333333333330
00000000000000000000