0000000000
0111111111
0221111111
0121111111
0121111111
0122211111
0121211111
0444222111
0334442111
0333344111
0533334111
0533334411
0553333411
0553444411
