0000000000
0111111111
0221111111
0121111111
0121111111
0122211111
0121211111
0122221111
0331121111
0333322111
0333332111
0333332111
0333333111
0333111111
